Command line commands:

pwd   - Print Working Directory
ls    - Lists all files and directories in the working directory
cd    - Change Directory
mkdir - Creates new directory in working directory
touch - Creates a new file inside the working directory

ls -a   - Lists all contents of a directory, including hidden files and directories
ls -l   - Lists all contents in long format
ls -t   - Orders files and directories by the time they were last modified
ls -alt - Combine all three options

cp      - Copies files
mv      - Moves and renames files
rm      - Removes files
rm -r   - Removes directories
*       - Wildcard, use to select and group files by name

>   - Redirects standard output of a command to a file, overwriting previous content
>>  - Redirects standard output of a command to a file, appending new content to old content
<   - Redirects standard input to a command
|   - Redirects standard output of a command to another command

sort    - Sorts lines of text alphabetically
uniq    - Filters duplicate, adjacent lines of text
grep    - Searches for a text pattern and outputs it
sed     - Searches for a text pattern, modifies it, and outputs it

nano                    - Command line text editor
~/.bash_profile         - Where environment settings are stored, can edit with nano
export VARIABLE="Value" - Sets and exports an environment variable
USER                    - Name of current user
PS1                     - Command prompt
HOME                    - Home directory
PATH                    - Returns a colon separate list of file paths
env                     - Returns a list of environment variables

alias newCommand="command"  - Set custom commands and shortcuts to  regular commands
